1 1 1 1 1 1
1 2 0 1 0 0
1 3 1 1 0 0
1 4 1 0 0 1
1 5 0 1 0 0
2 0 1 1 0 1
2 3 0 0 0 1
3 1 0 1 0 1
3 2 0 1 0 0
3 3 0 1 0 1
3 5 1 1 1 0
4 0 0 1 0 0
4 1 0 1 0 0
4 3 0 1 1 1
4 5 0 1 0 0
